111111111111111111111111111111
1E00C00P0000000000001111111111
111111111111111111111111111111