111111111111
10PEC0000001
100000000001
111111111111