1111111111111111111111111111111
1E00C00P00000000000011111111111
1111111111111111111111111111111