111111111111
10PE0000C001
100000000001
111111111111