111111111111111111111
100C00000000111100001
100000000000100000001
10000E00000010000P001
100000000000000000001
111111111111111111111